"filename", "language", "cpp", "Database", "comment", "blank", "total"
"/home/samchau/Uni/OOProject/include/Drawable/Button.cpp", "cpp", 34, 0, 0, 12, 46
"/home/samchau/Uni/OOProject/include/Drawable/Character.cpp", "cpp", 85, 0, 0, 17, 102
"/home/samchau/Uni/OOProject/include/Entity/Enemy.cpp", "cpp", 7, 0, 0, 4, 11
"/home/samchau/Uni/OOProject/include/Entity/Entity.cpp", "cpp", 113, 0, 0, 24, 137
"/home/samchau/Uni/OOProject/include/Entity/Player.cpp", "cpp", 27, 0, 0, 8, 35
"/home/samchau/Uni/OOProject/include/Instance/Game.cpp", "cpp", 24, 0, 0, 12, 36
"/home/samchau/Uni/OOProject/include/Instance/animations.db", "Database", 0, 13, 0, 0, 13
"/home/samchau/Uni/OOProject/include/State/MapState.cpp", "cpp", 34, 0, 0, 7, 41
"/home/samchau/Uni/OOProject/include/State/MenuState.cpp", "cpp", 47, 0, 0, 14, 61
"/home/samchau/Uni/OOProject/include/State/PickState.cpp", "cpp", 112, 0, 0, 20, 132
"/home/samchau/Uni/OOProject/include/State/PlayState.cpp", "cpp", 83, 0, 0, 21, 104
"/home/samchau/Uni/OOProject/include/State/State.cpp", "cpp", 6, 0, 0, 1, 7
"Total", "-", 572, 13, 0, 140, 725