"filename", "language", "cpp", "Database", "comment", "blank", "total"
"/home/samchau/Uni/OOProject/include/Drawable/DynamicSprite.cpp", "cpp", -7, 0, 0, -4, -11
"/home/samchau/Uni/OOProject/include/Drawable/Sprite.cpp", "cpp", -104, 0, 0, -23, -127
"/home/samchau/Uni/OOProject/include/Drawable/Text.cpp", "cpp", -52, 0, 0, -14, -66
"/home/samchau/Uni/OOProject/include/Entity/Enemy.cpp", "cpp", -7, 0, 0, -4, -11
"/home/samchau/Uni/OOProject/include/Entity/Entity.cpp", "cpp", -113, 0, 0, -24, -137
"/home/samchau/Uni/OOProject/include/Entity/Player.cpp", "cpp", -27, 0, 0, -8, -35
"/home/samchau/Uni/OOProject/include/Instance/Game.cpp", "cpp", -24, 0, 0, -11, -35
"/home/samchau/Uni/OOProject/include/Instance/Path.cpp", "cpp", -7, 0, 0, -4, -11
"/home/samchau/Uni/OOProject/include/Instance/animations.db", "Database", 0, -13, 0, 0, -13
"/home/samchau/Uni/OOProject/include/SFML/Audio.hpp", "cpp", -50, 0, 0, -7, -57
"/home/samchau/Uni/OOProject/include/SFML/Audio/AlResource.hpp", "cpp", -60, 0, 0, -11, -71
"/home/samchau/Uni/OOProject/include/SFML/Audio/Export.hpp", "cpp", -38, 0, 0, -11, -49
"/home/samchau/Uni/OOProject/include/SFML/Audio/InputSoundFile.hpp", "cpp", -236, 0, 0, -28, -264
"/home/samchau/Uni/OOProject/include/SFML/Audio/Listener.hpp", "cpp", -214, 0, 0, -21, -235
"/home/samchau/Uni/OOProject/include/SFML/Audio/Music.hpp", "cpp", -304, 0, 0, -34, -338
"/home/samchau/Uni/OOProject/include/SFML/Audio/OutputSoundFile.hpp", "cpp", -116, 0, 0, -18, -134
"/home/samchau/Uni/OOProject/include/SFML/Audio/Sound.hpp", "cpp", -236, 0, 0, -29, -265
"/home/samchau/Uni/OOProject/include/SFML/Audio/SoundBuffer.hpp", "cpp", -320, 0, 0, -33, -353
"/home/samchau/Uni/OOProject/include/SFML/Audio/SoundBufferRecorder.hpp", "cpp", -128, 0, 0, -17, -145
"/home/samchau/Uni/OOProject/include/SFML/Audio/SoundFileFactory.hpp", "cpp", -175, 0, 0, -23, -198
"/home/samchau/Uni/OOProject/include/SFML/Audio/SoundFileReader.hpp", "cpp", -150, 0, 0, -16, -166
"/home/samchau/Uni/OOProject/include/SFML/Audio/SoundFileWriter.hpp", "cpp", -113, 0, 0, -13, -126
"/home/samchau/Uni/OOProject/include/SFML/Audio/SoundRecorder.hpp", "cpp", -377, 0, 0, -32, -409
"/home/samchau/Uni/OOProject/include/SFML/Audio/SoundSource.hpp", "cpp", -299, 0, 0, -34, -333
"/home/samchau/Uni/OOProject/include/SFML/Audio/SoundStream.hpp", "cpp", -370, 0, 0, -36, -406
"/home/samchau/Uni/OOProject/include/SFML/Config.hpp", "cpp", -166, 0, 0, -71, -237
"/home/samchau/Uni/OOProject/include/SFML/GpuPreference.hpp", "cpp", -61, 0, 0, -14, -75
"/home/samchau/Uni/OOProject/include/SFML/Graphics.hpp", "cpp", -62, 0, 0, -7, -69
"/home/samchau/Uni/OOProject/include/SFML/Graphics/BlendMode.hpp", "cpp", -197, 0, 0, -19, -216
"/home/samchau/Uni/OOProject/include/SFML/Graphics/CircleShape.hpp", "cpp", -137, 0, 0, -18, -155
"/home/samchau/Uni/OOProject/include/SFML/Graphics/Color.hpp", "cpp", -252, 0, 0, -24, -276
"/home/samchau/Uni/OOProject/include/SFML/Graphics/ConvexShape.hpp", "cpp", -137, 0, 0, -17, -154
"/home/samchau/Uni/OOProject/include/SFML/Graphics/Drawable.hpp", "cpp", -112, 0, 0, -15, -127
"/home/samchau/Uni/OOProject/include/SFML/Graphics/Export.hpp", "cpp", -38, 0, 0, -11, -49
"/home/samchau/Uni/OOProject/include/SFML/Graphics/Font.hpp", "cpp", -401, 0, 0, -39, -440
"/home/samchau/Uni/OOProject/include/SFML/Graphics/Glsl.hpp", "cpp", -199, 0, 0, -29, -228
"/home/samchau/Uni/OOProject/include/SFML/Graphics/Glyph.hpp", "cpp", -68, 0, 0, -12, -80
"/home/samchau/Uni/OOProject/include/SFML/Graphics/Image.hpp", "cpp", -296, 0, 0, -29, -325
"/home/samchau/Uni/OOProject/include/SFML/Graphics/PrimitiveType.hpp", "cpp", -52, 0, 0, -7, -59
"/home/samchau/Uni/OOProject/include/SFML/Graphics/Rect.hpp", "cpp", -232, 0, 0, -23, -255
"/home/samchau/Uni/OOProject/include/SFML/Graphics/RectangleShape.hpp", "cpp", -116, 0, 0, -17, -133
"/home/samchau/Uni/OOProject/include/SFML/Graphics/RenderStates.hpp", "cpp", -156, 0, 0, -19, -175
"/home/samchau/Uni/OOProject/include/SFML/Graphics/RenderTarget.hpp", "cpp", -466, 0, 0, -45, -511
"/home/samchau/Uni/OOProject/include/SFML/Graphics/RenderTexture.hpp", "cpp", -288, 0, 0, -27, -315
"/home/samchau/Uni/OOProject/include/SFML/Graphics/RenderWindow.hpp", "cpp", -265, 0, 0, -20, -285
"/home/samchau/Uni/OOProject/include/SFML/Graphics/Shader.hpp", "cpp", -807, 0, 0, -69, -876
"/home/samchau/Uni/OOProject/include/SFML/Graphics/Shape.hpp", "cpp", -320, 0, 0, -36, -356
"/home/samchau/Uni/OOProject/include/SFML/Graphics/Sprite.hpp", "cpp", -253, 0, 0, -27, -280
"/home/samchau/Uni/OOProject/include/SFML/Graphics/Text.hpp", "cpp", -474, 0, 0, -40, -514
"/home/samchau/Uni/OOProject/include/SFML/Graphics/Texture.hpp", "cpp", -687, 0, 0, -47, -734
"/home/samchau/Uni/OOProject/include/SFML/Graphics/Transform.hpp", "cpp", -445, 0, 0, -35, -480
"/home/samchau/Uni/OOProject/include/SFML/Graphics/Transformable.hpp", "cpp", -398, 0, 0, -32, -430
"/home/samchau/Uni/OOProject/include/SFML/Graphics/Vertex.hpp", "cpp", -133, 0, 0, -16, -149
"/home/samchau/Uni/OOProject/include/SFML/Graphics/VertexArray.hpp", "cpp", -199, 0, 0, -25, -224
"/home/samchau/Uni/OOProject/include/SFML/Graphics/VertexBuffer.hpp", "cpp", -373, 0, 0, -36, -409
"/home/samchau/Uni/OOProject/include/SFML/Graphics/View.hpp", "cpp", -312, 0, 0, -32, -344
"/home/samchau/Uni/OOProject/include/SFML/Main.hpp", "cpp", -35, 0, 0, -9, -44
"/home/samchau/Uni/OOProject/include/SFML/Network.hpp", "cpp", -47, 0, 0, -7, -54
"/home/samchau/Uni/OOProject/include/SFML/Network/Export.hpp", "cpp", -38, 0, 0, -11, -49
"/home/samchau/Uni/OOProject/include/SFML/Network/Ftp.hpp", "cpp", -558, 0, 0, -59, -617
"/home/samchau/Uni/OOProject/include/SFML/Network/Http.hpp", "cpp", -434, 0, 0, -49, -483
"/home/samchau/Uni/OOProject/include/SFML/Network/IpAddress.hpp", "cpp", -297, 0, 0, -32, -329
"/home/samchau/Uni/OOProject/include/SFML/Network/Packet.hpp", "cpp", -472, 0, 0, -61, -533
"/home/samchau/Uni/OOProject/include/SFML/Network/Socket.hpp", "cpp", -193, 0, 0, -27, -220
"/home/samchau/Uni/OOProject/include/SFML/Network/SocketHandle.hpp", "cpp", -45, 0, 0, -13, -58
"/home/samchau/Uni/OOProject/include/SFML/Network/SocketSelector.hpp", "cpp", -241, 0, 0, -23, -264
"/home/samchau/Uni/OOProject/include/SFML/Network/TcpListener.hpp", "cpp", -150, 0, 0, -17, -167
"/home/samchau/Uni/OOProject/include/SFML/Network/TcpSocket.hpp", "cpp", -290, 0, 0, -27, -317
"/home/samchau/Uni/OOProject/include/SFML/Network/UdpSocket.hpp", "cpp", -270, 0, 0, -22, -292
"/home/samchau/Uni/OOProject/include/SFML/OpenGL.hpp", "cpp", -59, 0, 0, -20, -79
"/home/samchau/Uni/OOProject/include/SFML/System.hpp", "cpp", -55, 0, 0, -6, -61
"/home/samchau/Uni/OOProject/include/SFML/System/Clock.hpp", "cpp", -103, 0, 0, -15, -118
"/home/samchau/Uni/OOProject/include/SFML/System/Err.hpp", "cpp", -71, 0, 0, -10, -81
"/home/samchau/Uni/OOProject/include/SFML/System/Export.hpp", "cpp", -38, 0, 0, -11, -49
"/home/samchau/Uni/OOProject/include/SFML/System/FileInputStream.hpp", "cpp", -151, 0, 0, -19, -170
"/home/samchau/Uni/OOProject/include/SFML/System/InputStream.hpp", "cpp", -138, 0, 0, -15, -153
"/home/samchau/Uni/OOProject/include/SFML/System/Lock.hpp", "cpp", -125, 0, 0, -15, -140
"/home/samchau/Uni/OOProject/include/SFML/System/MemoryInputStream.hpp", "cpp", -131, 0, 0, -18, -149
"/home/samchau/Uni/OOProject/include/SFML/System/Mutex.hpp", "cpp", -132, 0, 0, -17, -149
"/home/samchau/Uni/OOProject/include/SFML/System/NativeActivity.hpp", "cpp", -51, 0, 0, -12, -63
"/home/samchau/Uni/OOProject/include/SFML/System/NonCopyable.hpp", "cpp", -115, 0, 0, -15, -130
"/home/samchau/Uni/OOProject/include/SFML/System/Sleep.hpp", "cpp", -45, 0, 0, -8, -53
"/home/samchau/Uni/OOProject/include/SFML/System/String.hpp", "cpp", -608, 0, 0, -62, -670
"/home/samchau/Uni/OOProject/include/SFML/System/Thread.hpp", "cpp", -261, 0, 0, -22, -283
"/home/samchau/Uni/OOProject/include/SFML/System/ThreadLocal.hpp", "cpp", -87, 0, 0, -17, -104
"/home/samchau/Uni/OOProject/include/SFML/System/ThreadLocalPtr.hpp", "cpp", -142, 0, 0, -17, -159
"/home/samchau/Uni/OOProject/include/SFML/System/Time.hpp", "cpp", -442, 0, 0, -47, -489
"/home/samchau/Uni/OOProject/include/SFML/System/Utf.hpp", "cpp", -706, 0, 0, -58, -764
"/home/samchau/Uni/OOProject/include/SFML/System/Vector2.hpp", "cpp", -275, 0, 0, -27, -302
"/home/samchau/Uni/OOProject/include/SFML/System/Vector3.hpp", "cpp", -276, 0, 0, -27, -303
"/home/samchau/Uni/OOProject/include/SFML/Window.hpp", "cpp", -51, 0, 0, -8, -59
"/home/samchau/Uni/OOProject/include/SFML/Window/Clipboard.hpp", "cpp", -108, 0, 0, -12, -120
"/home/samchau/Uni/OOProject/include/SFML/Window/Context.hpp", "cpp", -174, 0, 0, -22, -196
"/home/samchau/Uni/OOProject/include/SFML/Window/ContextSettings.hpp", "cpp", -139, 0, 0, -11, -150
"/home/samchau/Uni/OOProject/include/SFML/Window/Cursor.hpp", "cpp", -202, 0, 0, -21, -223
"/home/samchau/Uni/OOProject/include/SFML/Window/Event.hpp", "cpp", -259, 0, 0, -26, -285
"/home/samchau/Uni/OOProject/include/SFML/Window/Export.hpp", "cpp", -38, 0, 0, -11, -49
"/home/samchau/Uni/OOProject/include/SFML/Window/GlResource.hpp", "cpp", -93, 0, 0, -17, -110
"/home/samchau/Uni/OOProject/include/SFML/Window/Joystick.hpp", "cpp", -207, 0, 0, -21, -228
"/home/samchau/Uni/OOProject/include/SFML/Window/Keyboard.hpp", "cpp", -217, 0, 0, -16, -233
"/home/samchau/Uni/OOProject/include/SFML/Window/Mouse.hpp", "cpp", -159, 0, 0, -19, -178
"/home/samchau/Uni/OOProject/include/SFML/Window/Sensor.hpp", "cpp", -136, 0, 0, -15, -151
"/home/samchau/Uni/OOProject/include/SFML/Window/Touch.hpp", "cpp", -124, 0, 0, -14, -138
"/home/samchau/Uni/OOProject/include/SFML/Window/VideoMode.hpp", "cpp", -207, 0, 0, -22, -229
"/home/samchau/Uni/OOProject/include/SFML/Window/Window.hpp", "cpp", -574, 0, 0, -49, -623
"/home/samchau/Uni/OOProject/include/SFML/Window/WindowHandle.hpp", "cpp", -81, 0, 0, -21, -102
"/home/samchau/Uni/OOProject/include/SFML/Window/WindowStyle.hpp", "cpp", -46, 0, 0, -8, -54
"Total", "-", -21525, -13, 0, -2441, -23979