"filename", "language", "cpp", "Database", "comment", "blank", "total"
"/home/samchau/Uni/OOProject/include/Drawable/Button.cpp", "cpp", 34, 0, 0, 12, 46
"/home/samchau/Uni/OOProject/include/Drawable/Character.cpp", "cpp", 78, 0, 0, 19, 97
"/home/samchau/Uni/OOProject/include/Entity/Enemy.cpp", "cpp", 7, 0, 0, 4, 11
"/home/samchau/Uni/OOProject/include/Entity/Entity.cpp", "cpp", 84, 0, 0, 16, 100
"/home/samchau/Uni/OOProject/include/Entity/Player.cpp", "cpp", 44, 0, 0, 16, 60
"/home/samchau/Uni/OOProject/include/Instance/Game.cpp", "cpp", 24, 0, 0, 12, 36
"/home/samchau/Uni/OOProject/include/Instance/animations.db", "Database", 0, 13, 0, 0, 13
"/home/samchau/Uni/OOProject/include/State/MapState.cpp", "cpp", 34, 0, 0, 7, 41
"/home/samchau/Uni/OOProject/include/State/MenuState.cpp", "cpp", 47, 0, 0, 14, 61
"/home/samchau/Uni/OOProject/include/State/PickState.cpp", "cpp", 109, 0, 0, 19, 128
"/home/samchau/Uni/OOProject/include/State/PlayState.cpp", "cpp", 45, 0, 0, 12, 57
"/home/samchau/Uni/OOProject/include/State/State.cpp", "cpp", 6, 0, 0, 1, 7
"Total", "-", 512, 13, 0, 132, 657